NO textures/no_wall.png
SO textures/so_wall.png
WE textures/we_wall.png
EA textures/ea_wall.png

C 45,0,0
F 20,20,20

1111111111111
1000000000001
100N000000001
1000000S00001
1111111111111