NO textures/no_wall.png
SO textures/so_wall.png
WE textures/we_wall.png
EA textures/ea_wall.png
C 45,0,0
F 20,20,20
1111111111111111111111111
1000000000110000000000001
1011000001110000000000001
10010000000000000000000011111111
111111111011000001110000000000001
100000000011000001110111111111111
11110111111111011100000000001
11110111111111011101010000001
11000000110101011100000010001
10000000000000000000000010001
10000000000000000001010010001
11000001110101011111011110N0111
11110111 1110101 101111010001
11111111 1111111 111111111111