NO textures/no_wall.png
SO textures/so_wall.png
WE textures/we_wall.png
EA textures/ea_wall.png

C 45,0,0
F 20,20,20

111111111111111111111111111111111111
111111100001100000000000000011111111
111111001100011111110000000000011111
111110011111000111111000111100000001
111110111111100011110000001111111111
11110000W111110000000001111111111111
111111111111111111111111111111111111