NO textures/no_wall.png
SO textures/so_wall.png
WE textures/we_wall.png
EA textures/ea_wall.png

C 45,0,0
F 20,20,20

111111
100101
101001
1100N1
111111