NO textures/no_wall.png
SO textures/so_wall.png
WE textures/we_wall.png
EA textures/ea_wall.png

C 45,0,0
F 20,20,20

1111111111111111111111111111
1000000000000000000000000001
1000000000111110000000000001
1000000000111110000000000001
1000000000111110000000000001
1000000000111110000000000001
10000000000000N0000000000001
1000000000000000000000000001
1000000000000000000011100001
1000000000000000000011100001
1000000000000000000011100001
1000000000000000000000000001
1111111111111111111111111111